"a" = (/turf,/area)
"b" = (/obj/spaceship/door,/turf/spaceship,/area)
"c" = (/turf/wallrock,/area)
"d" = (/obj/spaceship/wall/corner,/turf/ground,/area)
"e" = (/obj/spaceship/console,/turf/ground,/area)
"f" = (/obj/spaceship/console/dirt_analyser,/turf/ground,/area)
"g" = (/obj/spaceship/console{icon_state = "console_left"},/turf/ground,/area)
"h" = (/obj/spaceship/wall/corner{icon_state = "corner2"},/turf/ground,/area)
"i" = (/obj/spaceship/wall{icon_state = "wall4"},/turf/ground,/area)
"j" = (/turf/spaceship,/area)
"k" = (/obj/spaceship/wall{icon_state = "wall1"},/turf/ground,/area)
"l" = (/obj/barrier_mark,/turf/spaceship,/area)
"m" = (/turf/spaceship,/area/home_mark)
"o" = (/obj/spaceship/wall/corner{icon_state = "corner4"},/turf/ground,/area)
"p" = (/obj/spaceship/wall{icon_state = "wall2"},/turf/ground,/area)
"q" = (/obj/spaceship/window,/turf/ground,/area)
"r" = (/obj/spaceship/wall/corner{icon_state = "corner3"},/turf/ground,/area)
"s" = (/obj/rock,/turf/wallrock,/area)
"t" = (/obj/rock/stone,/turf/wallrock,/area)
"u" = (/obj/spaceship/light,/turf/spaceship,/area)
"v" = (/obj/spaceship/sit,/turf/spaceship,/area)
"w" = (/mob/hostile/alien,/turf/ground,/area)
"x" = (/turf/ground,/area)
"z" = (/obj/rock/stone,/turf/ground,/area)
"A" = (/obj/item/shovel,/turf/ground,/area)

(1,1,1) = {"
aaaaaaaaaaaaaaaaaaaaaaaaaaaaaaaaaaaaaaaaaaaaaaaaaaaaaaaaaaaaaaaaaaaaaaaaaaa
aaaaaaaaaaaaaaaaaaaaaaaaaaaaaaaaaaaaaaaaaaaaaaaaaaaaaaaaaaaaaaaaaaaaaaaaaaa
aaaaaaaaaaaaaaaaaaaaaaaaaaaaaaaaaaaaaaaaaaaaaaaaaaaaaaaaaaaaaaaaaaaaaaaaaaa
aaaaaaaaaaaaaaaaaaaaaaaaaaaaaaaaaaaaaaaaaaaaaaaaaaaaaaaaaaaaaaaaaaaaaaaaaaa
aaaaaaaaaaaaaaaaaaaaaaaaaaaaaaaaaaaaaaaaaaaaaaaaaaaaaaaaaaaaaaaaaaaaaaaaaaa
aaaaaaaaaaaaaaaaaaaaaaaaaaaaaaaaaaaaaaaaaaaaaaaaaaaaaaaaaaaaaaaaaaaaaaaaaaa
aaaaaaaaaaaaaaaaaaaaaaaaaaaaaaaaaaaaaaaaaaaaaaaaaaaaaaaaaaaaaaaaaaaaaaaaaaa
aaaaaaaaaaaaaaaaaaaaaaaaaaaaaaaaaaaaaaaaaaaaaaaaaaaaaaaaaaaaaaaaaaaaaaaaaaa
aaaaaaaaaaaaaaaaaaaaaaaaaaaaaaaaaaaaaaaaaaaaaaaaaaaaaaaaaaaaaaaaaaaaaaaaaaa
aaaaaaaaaaaaaaaaaaaaaaaaaaaaaaaaaaaaaaaaaaaaaaaaaaaaaaaaaaaaaaaaaaaaaaaaaaa
aaaaaaaaaaaaaaaaaaaaaaaaaaaaaaaaaaaaaaaaaaaaaaaaaaaaaaaaaaaaaaaaaaaaaaaaaaa
aaaaaaaaaaaaaaaaaaaaaaaaaaaaaaaaaaaaaaaaaaaaaaaaaaaaaaaaaaaaaaaaaaaaaaaaaaa
ccccccccccccaaaaaaaaaaaaaaaaaaaaaaaaaaaaaaaaaaaaaaaaaaaaaaaaaaaaaaaaaaaaaaa
ccccccccccccaaaaaaaaaaaaaaaaaaaaaaaaaaaaaaaaaaaaaaaaaaaaaaaaaaaaaaaaaaaaaaa
ccccccccccccaaaaaaaaaaaaaaaaaaaaaaaaaaaaaaaaaaaaaaaaaaaaaaaaaaaaaaaaaaaaaaa
ccccccccccccaaaaaaaaaaaaaaaaaaaaaaaaaaaaaaaaaaaaaaaaaaaaaaaaaaaaaaaaaaaaaaa
ccccccccccccaaaaaaaaaaaaaaaaaaaaaaaaaaaaaaaaaaaaaaaaaaaaaaaaaaaaaaaaaaaaaaa
ccccccccccccaaaaaaaaaaaaaaaaaaaaaaaaaaaaaaaaaaaaaaaaaaaaaaaaaaaaaaaaaaaaaaa
ccccccccccccaaaaaaaaaaaaaaaaaaaaaaaaaaaaaaaaaaaaaaaaaaaaaaaaaaaaaaaaaaaaaaa
ccccccccccccaaaaaaaaaaaaaaaaaaaaaaaaaaaaaaaaaaaaaaaaaaaaaaaaaaaaaaaaaaaaaaa
ccccccccccccaaaaaaaaaaaaaaaaaaaaaaaaaaaaaaaaaaaaaaaaaaaaaaaaaaaaaaaaaaaaaaa
ccccccccccccaaaaaaaaaaaaaaaaaaaaaaaaaaaaaaaaaaaaaaaaaaaaaaaaaaaaaaaaaaaaaaa
ccccccccccccaaaaaaaaaaaaaaaaaaaaaaaaaaaaaaaaaaaaaaaaaaaaaaaaaaaaaaaaaaaaaaa
ccccccccccccaaaaaaaaaaaaaaaaaaaaaaaaaaaaaaaaaaaaaaaaaaaaaaaaaaaaaaaaaaaaaaa
ccccccccccccaaaaaaaaaaaaaaaaaaaaaaaaaaaaaaaaaaaaaaaaaaaaaaaaaaaaaaaaaaaaaaa
ccccccccccccaaaaaaaaaaaaaaaaaaaaaaaaaaaaaaaaaaaaaaaaaaaaaaaaaaaaaaaaaaaaaaa
ccccccccccccaaaaaaaaaaaaaaaaaaaaaaaaaaaaaaaaaaaaaaaaaaaaaaaaaaaaaaaaaaaaaaa
ccccccccccccaaaaaaaaaaaaaaaaaaaaaaaaaaaaaaaaaaaaaaaaaaaaaaaaaaaaaaaaaaaaaaa
ccccccccccccaaaaaaaaaaaaaaaaaaaaaaaaaaaaaaaaaaaaaaaaaaaaaaaaaaaaaaaaaaaaaaa
ccccccccccccccccccccccccccccccccccccccccccccccccccccccccccccccccccccccccccc
ccccccccccccccccccccccccccccccccccccccccccccccccccccccccccccccccccccccccccc
ccccccccccccccccccccccccccccccccccccccccccccccccccccccccccccccccccccccccccc
ccccccccccccccccccccccccccccccccccccccccccccccccccccccccccccccccccccccccccc
ccccccccccccccccccccccccccccccccccccccccccccccccccccccccccccccccccccccccccc
ccccccccccccccccccccccccccccccccccccccccccccccccccccccccccccccccccccccccccc
ccccccccccccccccccccccccccccccccccccccccccccccccccccccccccccccccccccccccccc
ccccccccccccccccccccccccccccccccccccccccccccccccccccccccccccccccccccccccccc
ccccccccccccccccccccccccccccccccccccccccccccccccccccccccccccccccccccccccccc
ccccccccccccccccccccccccccccccccccccccccccccccccccccccccccccccccccccccccccc
ccccccccccccccccccccccccccccccccccccccccccccccccccccccccccccccccccccccccccc
ccccccccccccccccccccccccccccccccccccccccccccccccccccccccccccccccccccccccccc
ccccccccccccccccccccccccccccccccccccccccccccccccccccccccccccccccccccccccccc
ccccccccccccccccccccccxxxcccccccccccccccccccccccccccccccccccccccccccccccccc
ccccccccccccccccccccxxxxxxxxxxxxccccccccccccccccccccccccccccccccccccccccccc
ccccccccccccccxxxxxxxxxxxxxxxxxxxxccccccccccccccccccccccccccccccccccccccccc
cccccccccccccxxxxwxxxxxxxxxxxxxxxxxxcccxccccccccccccccccccccccccccccccccccc
cccccccccccccxxxxxxxxxxxxxxxxxxxxxxxxxxxccccccccccccccccccccccccccccccccccc
cccccccccccccxxxxxxxxxxxxxxxxxxxxxxxxxxxccccccccccccccccccccccccccccccccccc
ccccccccccccxxxxzxzxxxxxxxxxxxxxxxxxxxxcccccccccccccccccccccccccccccccccccc
ccccccccccxxxxxxxxxxxxxxxxxxxxxxxxxxxxxcccccccccccccccccccccccccccccccccccc
cccccccccxxxxxxzxxxzzxxxxxxxxxxxxxxxxxccccccccccccccccccccccccccccccccccccc
ccccccccxxxxxxxxxxxxxxxxxxxdegfhxxxxxxccccccccccccccccccccccccccccccccccccc
ccccccccxxxccxxxxzxxxxzxxxxijvjkxxxxxxxcccccccccccccccccccccccccccccccccccc
cccccccccxccccxxxxzxxxxxxxxiulmbxAxxxxxxccccccccccccccccccccccccccccccccccc
ccccccccccccccxxxxxxxxxxxxxijjjkxxxxxxxxccccccccccccccccccccccccccccccccccc
cccccccccccccccxxzxxzxxxxxxopqprxxxxxxxcccccccccccccccccccccccccccccccccccc
cccccccccccccccxxxxxxxxxxxxxxxxxxxxxxxccccccccccccccccccccccccccccccccccccc
cccccccccccccccccxxxxxxxxxxxxxxxxxxxxxccccccccccccccccccccccccccccccccccccc
ccccccccccccccccccccxxxxxxxxxxxxxxxxxcccccccccccccccccccccccccccccccccccccc
ccccccccccccccccccccxxxxxxxxxxxxxxxxxcccccccccccccccccccccccccccccccccccccc
cccccccccccccccccccccxxxxxxxxxxxxxxxxcccccccccccccccccccccccccccccccccccccc
ccccccccccccccccccccccxxxxxxxxxxxxxxxcccccccccccccccccccccccccccccccccccccc
ccccccccccccccccccccccccccxxxxxxxxxxccccccccccccccccccccccccccccccccccccccc
ccccccccccccccccccccccccccccccxxccccccccccccccccccccccccccccccccccccccccccc
ccccccccccccccccccccccccccccccccccccccccccccccccccccccccccccccccccccccccccc
ccccccccccccccccccccccccccccccccccccccccccccccccccccccccccccccccccccccccccc
ccccccccccccccccccccccccccccccccccccccccccccccccccccccccccccccccccccccccccc
ccccccccccccccccccccccccccccccccccccccccccccccccccccccccccccccccccccccccccc
ccccccccccccccccccccccccccccccccccccccccccccccccccccccccccccccccccccccccccc
ccccccccccccccccccccccccccccccccccccccccccccccccccccccccccccccccccccccccccc
ccccccccccccccccccccccccccccccccccccccccccccccccccccccccccccccccccccccccccc
cccccccccsssssccccccccccccccccccccccccccccccccccccccccccccccccccccccccccccc
ccccccccstccctscccccccccccccccccccccccccccccccccccccccccccccccccccccccccccc
cccccccsscccccssssccccccccccccccccccccccccccccccccccccccccccccccccccccccccc
ccccccsscccccccccsssccccccccccccccccccccccccccccccccccccccccccccccccccccccc
"}
